.#s#................
.#.#................
.#.############.....
.#............#.....
.############.#.....
.......#....#.#.....
.......#.##.#.#.....
.......#.##.#.#.....
.......#.##...#.....
.......#.######.....
.......#.###########
.......#...........f
.......#############
....................
....................
....................
....................
....................
....................
....................